111111111
1E0C00001
100P00001
100C00101
111111111