111111111111111111111111
1P0000C00000000010000C01
100000000C000000100000C1
1C00000C000000C010000001
100000000000000000000001
1000000C0000000011110001
10000000000000000C010001
100001100000C00011110001
10000010000000000C000001
100C0010000C0000000E00C1
111111111111111111111111